0,0xFF0000 0,0xff0000 0,0xfF0000 0,0xFf0000 0,0xFF0000
0,0xFF0000 1,0xFF6600 2,0x66FF00 1,0xFF6600 0,0xFF0000
0,0xFF0000 2,0x66FF00 3,0x00c0ff 2,0x66FF00 0,0xFF0000
0,0xFF0000 1,0xFF6600 2,0x66FF00 1,0xFF6600 0,0xFF0000
0,0xFF0000 0,0xff0000 0,0xfF0000 0,0xFf0000 0,0xFF0000
